1111111111111111111
1000000000000000001
1010101011111110101
1010101000001000101
1010101110101011101
1000100000101010001
1110111111101010101
0000000000001000100
1011111111111011101
1000000000000000101
1110101111111110101
1000021000000013101
1011111011111010101
1000001010000000101
1011101010111111101
0010001010000000000
1010111010101011101
1010001010001010001
1011101011111010101
1000000000000010001
1111111111111111111
