1111111111111111111
1000001000000000001
1011101011111110101
1000101000000010101
1010101011101010101
1010101000101010001
1010101110101010101
0010000000101010000
1011111111101011101
1010000000001000101
1010111110111110101
1010001200000300101
1011101011111111101
1000100000000000001
1110111010111011101
0000000010100000100
1011111110101110101
1010001000101000101
1010101011101011101
1000100000001000001
1111111111111111111
