111111111111111111111111111111111
100000000000000000000000000000001
101110101111010111010101111010101
100010000000000000000000000000001
111010101111010101110101101010101
100000000000010101000000000010001
101010111011010101010101101010101
100010000000000000000000000000101
101010101111010101011101101110101
000000100000000000000000001000100
101010101011110111110111111010101
101010101011110111110111111010101
100000001111000000000111101000001
111111101011011101110101101010111
100000002411000001000150301010001
101011101011010101011101101011101
100000001111010000010111100000001
101010111011010101010101101010111
000000000000010000010001100000000
101110101011010101010101101110101
100000001011000101010100000000101
101010101011010101010101111010101
100000001000000000010101100000001
111010101111111101010101101110101
100000000000000001000001100000101
101110101111110101010101101010101
100000000000000001000100001000001
111111111111111111111111111111111
