1111111111111111111
1000000000000000001
1011111110101111101
1010000010101000001
1010111010101011101
1000100010101000101
1111101010101110101
0000001010100010000
1010101010111010111
1010001010100010001
1011111010101111101
1010020010000003001
1010111111111011101
1010001000001000101
1010101010101110101
0000100010100000100
1011111110101111101
1000100000001000001
1010101010111011101
1000000010000000001
1111111111111111111
