1111111111111111111
1000000000100010001
1011111010101010101
1000000010001000101
1011101111111111101
1000100000100000001
1010111010101111111
0010001010101000000
1010101010101010101
1010001010000010101
1011101011111110101
1000001200100310001
1111111110101011101
1000000010101000101
1011111010101010101
0000100000101010100
1010101111101010101
1010000000001010001
1011111111111011101
1000000000000000001
1111111111111111111