1111111111111111111
1000100000001000001
1010101110101011101
1000100010000010001
1011101011111110101
1000001010000000101
1010111010111111101
0010001000001000000
1011101111101011101
1000101000001000101
1010101011101110101
1000100200101300101
1010111110101011101
1010000000100010001
1011101010111110101
0000101010001000100
1110101011101010101
1000001000000010001
1011101111111111101
1000000000000000001
1111111111111111111
