1111111111111111111
1000001000100000001
1011101010101111101
1000100010000010001
1110101111111010111
1000101000001010001
1011101010101011101
0000001010100010000
1110111010111010101
1000001010001000101
1010101011101110101
1000120010001003101
1011111110111011101
1000000010001000001
1110111011101010111
0000000010001010000
1011111110111011101
1010000010100000001
1010111010101011101
1000000000001000001
1111111111111111111
