1111111111111111111
1000100000000010001
1010101011111010101
1000101000000000101
1011101111101111101
1000000000101000001
1111111110101011111
0000001000101000000
1011101011101111101
1010001010001000101
1010111010111010101
1010021010000003101
1010101011101111101
1000101010001000001
1011101010101011111
0000100010001000000
1010111111111011101
1010000000001000001
1011111111101110101
1000000000000000001
1111111111111111111
