1111111111111111111
1000001000000000001
1011101011111010101
1010001000001010001
1010111111101010111
1010000000000010001
1010111010111110101
0010001000100010000
1011101111101011101
1000100000001000001
1010111111111110101
1010021000000003101
1011101011101011101
1000100010001010001
1110111110111010111
0000001000100010000
1011101011101110101
1000001000100010101
1011111110111010101
1000000000000000001
1111111111111111111
