111111111111111111111111111111111
100000000000000000000001100000001
101011111101010111011101101010101
101000000101010000000100000000001
101011010101010101110111101110101
101011010101010101110111101110101
100011010001000000000000000000001
111011010101010101010101111111101
100011000000010100000000000000001
101011111101010101110101101110101
000011000001000001000000000000000
101011010111011101010111101010101
100000010111000100010111100000001
101011011101010111010101101011101
100011000241000100000150300000001
101011110101011101011101101010101
101000010111000001000111100000001
101111010101011111011111111011101
000000000000000100010000001000000
101011010111010101010111101111101
101000000000000000000000000010001
101011111101011101011101101010101
100000000100000000010000000010101
101011010101010111010101101010101
100000000000010000000000001010001
101011010101011111110101101010101
100000000000000000000000000000001
111111111111111111111111111111111
