1111111111111111111
1000000010000000001
1010111010101111101
1010001010000000101
1010101011111110101
1000101000100000101
1111101110101111101
0000100000101000100
1010101111101010101
1000100010000010101
1010111010101010101
1010001210101300001
1011101010101111111
1010000010001000001
1010111110111011101
0010100000000010000
1010101111111010101
1010100000001010101
1010111010101010101
1000000010000000001
1111111111111111111
