1111111111111111111
1000001000001000001
1011101010101011101
1000101010101000101
1010101010101010101
1010100010101010001
1010111110101010101
0010001000101000100
1011101011101111101
1000100000100000101
1010111110111110101
1000100200100300101
1011101010101111101
1010001010100010001
1010111010111010101
0000001010100010100
1011101010101110101
1000100010100010101
1010101110111010101
1000100000000000001
1111111111111111111
